44444444111111101111111111111111
10000000000000000000000000000011
10001000000000000000000010000001
10000000000000000000000000000011
10000000010000001000000000000001
10000000000000000000000000000011
10000000000000000000000010000001
10000000000000000000000000000011
10000000000000000000000000000001
10000000000000000001000000000011
10000000100000000000000000000001
00000000000000001000000000000011
10000001000000000000000010000001
10000000000000000000000000000011
10000000000000000000000000000001
12000000000000000100000000000021
12001012345670000000000000000021
10000000000000000000000000000011
10000000000000000000100000000000
10000000010000434500000000000011
10000000000000300300000000000001
10000000000001403300001000000011
10000000000000000000000000000001
10001000000000000000000000000011
10000000000000000000000000000001
10000000000001000000000000000011
10000000000000000000000000000001
10001011011100000000000000000011
10001000000000000000000010000001
10001111111000000000000000000011
10000000000000000000000000000001
11111111111111111011111111111111